//MAP CONVERTED BY dmm2tgm.py THIS HEADER COMMENT PREVENTS RECONVERSION, DO NOT REMOVE
"aG" = (
/obj/structure/table/wood/plain,
/turf/open/floor/rogue/dirt/road,
/area/rogue/outdoors)
"cp" = (
/obj/machinery/light/rogue/firebowl/stump,
/turf/open/floor/rogue/cobblerock,
/area/rogue/outdoors)
"cX" = (
/obj/machinery/light/rogue/torchholder/c,
/turf/open/floor/rogue/dirt/road,
/area/rogue/outdoors)
"dS" = (
/obj/item/reagent_containers/glass/bucket/wooden,
/turf/open/floor/rogue/dirt/road,
/area/rogue/outdoors)
"dZ" = (
/obj/machinery/light/rogue/hearth,
/obj/item/cooking/pan,
/turf/open/floor/rogue/grass,
/area/rogue/outdoors)
"eR" = (
/obj/structure/cannon,
/turf/open/floor/rogue/cobble,
/area/rogue/outdoors)
"fG" = (
/obj/item/rogueweapon/pick,
/turf/open/floor/rogue/cobblerock,
/area/rogue/outdoors)
"fO" = (
/obj/structure/bed/rogue/sleepingbag,
/obj/effect/landmark/start/grenzelinfantry{
	dir = 1
	},
/turf/open/floor/rogue/dirt/road,
/area/rogue/outdoors)
"hq" = (
/turf/open/floor/rogue/cobble,
/area/rogue/outdoors)
"hY" = (
/obj/structure/cannon{
	dir = 1
	},
/turf/open/floor/rogue/cobble,
/area/rogue/outdoors)
"la" = (
/obj/machinery/light/rogue/torchholder/r,
/turf/open/floor/rogue/cobble,
/area/rogue/outdoors)
"mF" = (
/obj/structure/roguemachine/musicbox,
/turf/open/floor/rogue/dirt/road,
/area/rogue/outdoors)
"ou" = (
/turf/open/floor/rogue/grass,
/area/rogue/outdoors)
"rv" = (
/obj/effect/landmark/start/heartfeltinfantry,
/obj/structure/bed/rogue/sleepingbag,
/turf/open/floor/rogue/dirt/road,
/area/rogue/outdoors)
"so" = (
/obj/structure/table/wood{
	icon_state = "tablewood1"
	},
/obj/item/rogueweapon/tongs,
/obj/item/rogueweapon/hammer,
/turf/open/floor/rogue/cobblerock,
/area/rogue/outdoors)
"sv" = (
/obj/item/rogueweapon/pick,
/turf/open/floor/rogue/dirt,
/area/rogue/outdoors)
"sF" = (
/obj/item/rogueweapon/pick,
/turf/open/floor/rogue/grass,
/area/rogue/outdoors)
"sK" = (
/obj/structure/closet/crate/chest,
/obj/item/reagent_containers/food/snacks/rogue/crackerscooked,
/obj/item/reagent_containers/food/snacks/rogue/crackerscooked,
/obj/item/reagent_containers/food/snacks/rogue/crackerscooked,
/obj/item/reagent_containers/food/snacks/rogue/crackerscooked,
/obj/item/reagent_containers/food/snacks/rogue/crackerscooked,
/obj/item/reagent_containers/food/snacks/rogue/crackerscooked,
/obj/item/reagent_containers/food/snacks/rogue/crackerscooked,
/obj/item/reagent_containers/food/snacks/rogue/crackerscooked,
/turf/open/floor/rogue/dirt,
/area/rogue/outdoors)
"tx" = (
/obj/machinery/light/rogue/forge,
/turf/open/floor/rogue/cobblerock,
/area/rogue/outdoors)
"uH" = (
/obj/structure/table/wood/plain,
/obj/item/reagent_containers/glass/bucket/wooden,
/turf/open/floor/rogue/dirt,
/area/rogue/outdoors)
"vm" = (
/obj/effect/landmark/redreinforcement,
/turf/open/floor/rogue/dirt/road,
/area/rogue/outdoors)
"vv" = (
/obj/structure/warfarebarrier,
/turf/closed/mineral/random/rogue/high,
/area/rogue/outdoors)
"vH" = (
/obj/effect/landmark/start/grenzellord{
	dir = 1
	},
/turf/open/floor/rogue/dirt/road,
/area/rogue/outdoors)
"vR" = (
/obj/structure/closet/crate/chest,
/obj/item/ingot/steel,
/obj/item/ingot/steel,
/obj/item/ingot/steel,
/obj/item/ingot/steel,
/obj/item/ingot/steel,
/obj/item/ingot/steel,
/obj/item/ingot/steel,
/obj/item/ingot/steel,
/obj/item/ingot/steel,
/obj/item/ingot/steel,
/obj/item/ingot/steel,
/obj/item/ingot/steel,
/obj/item/ingot/steel,
/obj/item/ingot/steel,
/obj/item/ingot/steel,
/obj/item/ingot/steel,
/obj/item/ingot/steel,
/obj/item/ingot/steel,
/turf/open/floor/rogue/cobblerock,
/area/rogue/outdoors)
"AM" = (
/turf/closed/mineral/random/rogue/high,
/area/rogue/outdoors)
"Bz" = (
/obj/machinery/light/rogue/firebowl/stump,
/turf/open/floor/rogue/dirt/road,
/area/rogue/outdoors)
"BL" = (
/turf/open/floor/rogue/dirt,
/area/rogue/outdoors)
"Cb" = (
/obj/structure/closet/crate/chest,
/obj/item/flashlight/flare/torch/lantern,
/obj/item/flashlight/flare/torch/lantern,
/obj/item/flashlight/flare/torch/lantern,
/obj/item/flashlight/flare/torch/lantern,
/obj/item/flashlight/flare/torch/lantern,
/obj/item/flashlight/flare/torch/lantern,
/obj/item/flashlight/flare/torch/lantern,
/obj/item/flashlight/flare/torch/lantern,
/obj/item/flashlight/flare/torch/lantern,
/obj/item/flashlight/flare/torch/lantern,
/obj/item/flashlight/flare/torch/lantern,
/obj/item/flashlight/flare/torch/lantern,
/obj/item/flashlight/flare/torch/lantern,
/obj/item/flashlight/flare/torch/lantern,
/obj/item/flashlight/flare/torch/lantern,
/obj/item/flashlight/flare/torch/lantern,
/obj/item/flashlight/flare/torch/lantern,
/obj/item/flashlight/flare/torch/lantern,
/obj/item/flashlight/flare/torch/lantern,
/obj/item/flashlight/flare/torch/lantern,
/obj/item/flashlight/flare/torch/lantern,
/obj/item/flashlight/flare/torch/lantern,
/obj/item/flashlight/flare/torch/lantern,
/obj/item/flashlight/flare/torch/lantern,
/obj/item/flashlight/flare/torch/lantern,
/obj/item/flashlight/flare/torch/lantern,
/turf/open/floor/rogue/cobblerock,
/area/rogue/outdoors)
"Eh" = (
/obj/structure/fluff/grindwheel,
/turf/open/floor/rogue/cobblerock,
/area/rogue/outdoors)
"Fs" = (
/obj/machinery/light/rogue/hearth,
/obj/item/cooking/pan,
/turf/open/floor/rogue/dirt,
/area/rogue/outdoors)
"FA" = (
/obj/effect/landmark/blureinforcement,
/turf/open/floor/rogue/dirt/road,
/area/rogue/outdoors)
"FT" = (
/obj/structure/fermenting_barrel/beer,
/turf/open/floor/rogue/dirt/road,
/area/rogue/outdoors)
"GK" = (
/obj/structure/fermenting_barrel/beer,
/turf/open/floor/rogue/dirt,
/area/rogue/outdoors)
"Hk" = (
/obj/item/rogueweapon/pick,
/turf/open/floor/rogue/dirt/road,
/area/rogue/outdoors)
"Hl" = (
/obj/machinery/light/rogue/firebowl/stump,
/turf/open/floor/rogue/dirt,
/area/rogue/outdoors)
"Ho" = (
/obj/machinery/light/rogue/firebowl/stump,
/obj/item/rogueweapon/pick,
/turf/open/floor/rogue/cobblerock,
/area/rogue/outdoors)
"Hs" = (
/obj/machinery/light/rogue/torchholder/r,
/turf/open/floor/rogue/dirt/road,
/area/rogue/outdoors)
"HP" = (
/obj/effect/landmark/start/heartfeltlord,
/turf/open/floor/rogue/dirt/road,
/area/rogue/outdoors)
"ID" = (
/turf/open/lava,
/area/rogue/outdoors)
"IZ" = (
/obj/structure/roguemachine/musicbox,
/turf/open/floor/rogue/dirt,
/area/rogue/outdoors)
"Jl" = (
/obj/effect/landmark/start/heartfeltinfantry,
/obj/structure/bed/rogue/sleepingbag,
/turf/open/floor/rogue/dirt,
/area/rogue/outdoors)
"JG" = (
/obj/structure/table/wood/plain,
/obj/item/reagent_containers/glass/bucket/wooden,
/turf/open/floor/rogue/dirt/road,
/area/rogue/outdoors)
"JS" = (
/turf/open/floor/rogue/dirt/road,
/area/rogue/outdoors)
"Ke" = (
/obj/structure/closet/crate/chest,
/obj/item/reagent_containers/food/snacks/rogue/meat/steak,
/obj/item/reagent_containers/food/snacks/rogue/meat/steak,
/obj/item/reagent_containers/food/snacks/rogue/meat/steak,
/obj/item/reagent_containers/food/snacks/rogue/meat/steak,
/obj/item/reagent_containers/food/snacks/rogue/meat/steak,
/obj/item/reagent_containers/food/snacks/rogue/meat/steak,
/obj/item/reagent_containers/food/snacks/rogue/meat/steak,
/obj/item/reagent_containers/food/snacks/rogue/meat/steak,
/obj/item/reagent_containers/food/snacks/rogue/meat/steak,
/obj/item/reagent_containers/food/snacks/rogue/meat/steak,
/turf/open/floor/rogue/grass,
/area/rogue/outdoors)
"Le" = (
/obj/structure/table/wood/plain,
/obj/item/rogueweapon/pick,
/obj/item/rogueweapon/pick,
/obj/item/rogueweapon/pick,
/turf/open/floor/rogue/dirt,
/area/rogue/outdoors)
"LB" = (
/obj/machinery/light/rogue/torchholder/c,
/obj/structure/fermenting_barrel/beer,
/turf/open/floor/rogue/dirt/road,
/area/rogue/outdoors)
"LC" = (
/obj/structure/bed/rogue/sleepingbag,
/obj/effect/landmark/start/grenzelinfantry{
	dir = 1
	},
/turf/open/floor/rogue/dirt,
/area/rogue/outdoors)
"Ma" = (
/obj/item/roguebin/water/gross,
/turf/open/floor/rogue/cobblerock,
/area/rogue/outdoors)
"Nl" = (
/obj/item/grown/log/tree/small,
/obj/item/grown/log/tree/small,
/obj/item/grown/log/tree/small,
/obj/item/grown/log/tree/small,
/obj/item/grown/log/tree/small,
/obj/item/grown/log/tree/small,
/obj/item/grown/log/tree/small,
/obj/item/grown/log/tree/small,
/obj/item/grown/log/tree/small,
/obj/item/grown/log/tree/small,
/obj/item/grown/log/tree/small,
/obj/structure/closet/crate/chest,
/turf/open/floor/rogue/grass,
/area/rogue/outdoors)
"NZ" = (
/obj/effect/decal/remains/human,
/obj/effect/landmark/observer_start,
/turf/open/floor/rogue/cobble,
/area/rogue/outdoors)
"Oi" = (
/obj/machinery/light/rogue/torchholder/l,
/turf/open/floor/rogue/grass,
/area/rogue/outdoors)
"OI" = (
/obj/machinery/light/rogue/torchholder/r,
/turf/open/floor/rogue/grass,
/area/rogue/outdoors)
"QH" = (
/obj/structure/warfarebarrier/red,
/turf/closed/mineral/random/rogue/high,
/area/rogue/outdoors)
"So" = (
/obj/structure/fluff/ponr,
/turf/open/floor/rogue/dirt/road,
/area/rogue/outdoors)
"SH" = (
/obj/structure/closet/crate/chest,
/obj/item/ammo_casing/caseless/rogue/cball,
/obj/item/ammo_casing/caseless/rogue/cball,
/obj/item/ammo_casing/caseless/rogue/cball,
/obj/item/ammo_casing/caseless/rogue/cball,
/obj/item/ammo_casing/caseless/rogue/cball,
/obj/item/ammo_casing/caseless/rogue/cball,
/obj/item/ammo_casing/caseless/rogue/cball,
/obj/item/ammo_casing/caseless/rogue/cball,
/obj/item/ammo_casing/caseless/rogue/cball,
/obj/item/ammo_casing/caseless/rogue/cball,
/obj/item/ammo_casing/caseless/rogue/cball,
/obj/item/ammo_casing/caseless/rogue/cball,
/obj/item/ammo_casing/caseless/rogue/cball,
/obj/item/ammo_casing/caseless/rogue/cball,
/turf/open/floor/rogue/cobble,
/area/rogue/outdoors)
"Ty" = (
/turf/closed/wall/mineral/rogue/wooddark,
/area/rogue/outdoors)
"Uc" = (
/obj/machinery/anvil,
/turf/open/floor/rogue/cobblerock,
/area/rogue/outdoors)
"Vs" = (
/obj/structure/fluff/ponr/red,
/turf/open/floor/rogue/dirt,
/area/rogue/outdoors)
"Xm" = (
/obj/machinery/light/rogue/torchholder/l,
/turf/open/floor/rogue/dirt/road,
/area/rogue/outdoors)
"Xw" = (
/turf/open/floor/rogue/cobblerock,
/area/rogue/outdoors)
"Zi" = (
/turf/open/water/cleanshallow,
/area/rogue/outdoors)

(1,1,1) = {"
AM
AM
AM
AM
AM
AM
AM
AM
AM
AM
AM
AM
AM
AM
AM
AM
AM
AM
AM
QH
AM
AM
AM
AM
AM
AM
AM
AM
AM
AM
AM
AM
AM
AM
AM
AM
AM
AM
AM
AM
AM
vv
AM
AM
AM
AM
AM
AM
AM
AM
AM
AM
AM
AM
AM
AM
AM
AM
AM
AM
AM
AM
AM
AM
AM
"}
(2,1,1) = {"
AM
AM
AM
AM
AM
AM
AM
AM
AM
AM
AM
AM
AM
AM
AM
AM
AM
AM
AM
QH
AM
AM
AM
AM
AM
AM
AM
AM
AM
AM
AM
AM
AM
AM
AM
AM
AM
AM
AM
AM
AM
vv
AM
AM
AM
AM
AM
AM
AM
AM
AM
AM
AM
AM
AM
AM
AM
AM
AM
AM
AM
AM
AM
AM
AM
"}
(3,1,1) = {"
AM
AM
AM
AM
AM
AM
AM
AM
AM
AM
AM
AM
AM
AM
AM
AM
AM
AM
AM
QH
AM
AM
AM
AM
AM
AM
AM
AM
AM
AM
AM
AM
AM
AM
AM
AM
AM
AM
AM
AM
AM
vv
AM
AM
AM
AM
AM
AM
AM
AM
AM
AM
AM
AM
AM
AM
AM
AM
AM
AM
AM
AM
AM
AM
AM
"}
(4,1,1) = {"
AM
AM
AM
AM
AM
AM
AM
AM
AM
AM
AM
AM
AM
AM
AM
AM
AM
AM
AM
QH
AM
AM
AM
AM
AM
AM
AM
AM
AM
AM
AM
AM
AM
AM
AM
AM
AM
AM
AM
AM
AM
vv
AM
AM
AM
AM
AM
AM
AM
AM
AM
AM
AM
AM
AM
AM
AM
AM
AM
AM
AM
AM
AM
AM
AM
"}
(5,1,1) = {"
AM
AM
AM
AM
AM
AM
AM
AM
AM
AM
AM
AM
AM
AM
AM
AM
AM
AM
AM
QH
AM
AM
AM
AM
AM
AM
AM
AM
AM
AM
AM
AM
AM
AM
AM
AM
AM
AM
AM
AM
AM
vv
AM
AM
AM
AM
AM
AM
AM
AM
AM
AM
AM
AM
AM
AM
AM
AM
AM
AM
Xw
Xw
AM
AM
AM
"}
(6,1,1) = {"
AM
AM
AM
AM
AM
AM
AM
AM
AM
AM
AM
AM
AM
AM
AM
AM
AM
AM
AM
QH
AM
AM
AM
AM
AM
AM
AM
AM
AM
AM
AM
AM
AM
AM
AM
AM
AM
AM
AM
AM
AM
vv
AM
AM
AM
AM
AM
AM
AM
AM
AM
AM
AM
AM
AM
AM
AM
AM
AM
AM
Xw
Xw
AM
Xw
AM
"}
(7,1,1) = {"
AM
AM
AM
AM
AM
AM
AM
AM
AM
AM
AM
AM
AM
AM
AM
AM
AM
AM
AM
QH
AM
AM
AM
AM
AM
AM
AM
AM
AM
AM
AM
AM
AM
AM
AM
AM
AM
AM
AM
AM
AM
vv
AM
AM
AM
AM
AM
AM
AM
AM
AM
AM
AM
AM
AM
AM
AM
AM
AM
Xw
Xw
Xw
AM
Xw
AM
"}
(8,1,1) = {"
AM
AM
AM
AM
AM
AM
AM
AM
AM
AM
AM
AM
AM
AM
AM
AM
AM
AM
AM
QH
AM
AM
AM
AM
AM
AM
AM
AM
AM
AM
AM
AM
AM
AM
AM
AM
AM
AM
AM
AM
AM
vv
AM
AM
AM
AM
AM
AM
AM
AM
AM
AM
AM
AM
AM
Uc
tx
AM
Xw
BL
BL
Xw
Xw
Xw
AM
"}
(9,1,1) = {"
AM
AM
AM
AM
AM
AM
AM
AM
AM
AM
AM
AM
AM
AM
AM
AM
AM
AM
AM
QH
AM
AM
AM
AM
AM
AM
AM
AM
AM
AM
AM
AM
AM
AM
AM
AM
AM
AM
AM
AM
AM
vv
AM
AM
AM
AM
AM
AM
AM
AM
AM
AM
AM
AM
Ma
Xw
Xw
Xw
BL
ou
BL
BL
Xw
Xw
AM
"}
(10,1,1) = {"
AM
AM
AM
AM
AM
AM
AM
AM
AM
AM
AM
AM
AM
AM
AM
AM
AM
AM
AM
QH
AM
AM
AM
AM
AM
AM
AM
AM
AM
AM
AM
AM
AM
AM
AM
AM
AM
AM
AM
AM
AM
vv
AM
AM
AM
AM
AM
AM
AM
AM
AM
AM
AM
AM
Eh
Xw
Xw
Xw
BL
ou
ou
Zi
BL
BL
BL
"}
(11,1,1) = {"
AM
Xw
AM
AM
AM
AM
AM
AM
AM
AM
AM
AM
AM
AM
AM
AM
AM
AM
AM
QH
AM
AM
AM
AM
AM
AM
AM
AM
AM
AM
AM
AM
AM
AM
AM
AM
AM
AM
AM
AM
AM
vv
AM
AM
AM
AM
AM
AM
AM
AM
AM
AM
AM
AM
vR
Xw
Xw
BL
BL
BL
ou
Zi
Zi
BL
BL
"}
(12,1,1) = {"
cp
Xw
Xw
AM
Xw
Xw
AM
AM
AM
AM
AM
AM
AM
AM
AM
AM
AM
AM
AM
QH
AM
AM
AM
AM
AM
AM
AM
AM
AM
AM
AM
AM
AM
AM
AM
AM
AM
AM
AM
AM
AM
vv
AM
AM
AM
AM
AM
AM
AM
AM
AM
AM
AM
AM
so
Xw
BL
BL
ou
ou
BL
BL
Hl
GK
BL
"}
(13,1,1) = {"
Xw
sv
Xw
Xw
JS
Bz
tx
Uc
AM
AM
AM
AM
AM
AM
AM
AM
AM
AM
AM
QH
AM
AM
AM
AM
AM
AM
AM
AM
AM
AM
AM
AM
AM
AM
AM
AM
AM
AM
AM
AM
AM
vv
AM
AM
AM
AM
AM
AM
AM
AM
AM
AM
AM
AM
AM
Xw
BL
sK
BL
BL
BL
Fs
JS
JS
GK
"}
(14,1,1) = {"
JS
ou
ou
ou
JS
JS
JS
JS
Xw
Ma
AM
AM
AM
AM
AM
AM
AM
AM
AM
QH
AM
AM
AM
AM
AM
AM
AM
AM
AM
AM
AM
AM
AM
AM
AM
AM
AM
AM
AM
AM
AM
vv
AM
AM
AM
AM
AM
AM
AM
AM
AM
AM
AM
AM
AM
Xw
Nl
Ty
Ty
BL
Ke
BL
FT
Hk
uH
"}
(15,1,1) = {"
JS
BL
JS
Zi
Zi
JS
ou
FT
Hk
Eh
AM
AM
AM
AM
AM
AM
AM
AM
AM
QH
AM
AM
AM
AM
AM
AM
AM
AM
AM
AM
AM
AM
AM
AM
AM
AM
AM
AM
AM
AM
AM
vv
AM
AM
AM
AM
AM
AM
AM
AM
AM
AM
AM
AM
AM
AM
ou
Ty
Ty
cX
Fs
ou
JS
JS
BL
"}
(16,1,1) = {"
BL
Hl
Ty
Ty
FT
Zi
JS
JS
JS
vR
AM
AM
AM
AM
AM
AM
AM
AM
AM
QH
AM
AM
AM
AM
AM
AM
AM
ID
ID
AM
AM
ID
ID
ID
AM
AM
AM
AM
ID
ID
AM
vv
AM
AM
AM
AM
AM
AM
AM
AM
AM
AM
AM
AM
AM
AM
AM
Oi
ou
JS
JS
Ke
JS
FT
Le
"}
(17,1,1) = {"
Jl
Ke
Ty
Ty
LB
BL
uH
JS
Xw
so
AM
AM
AM
AM
AM
AM
AM
AM
AM
QH
AM
AM
AM
AM
AM
AM
AM
AM
ID
ID
ID
ID
hq
ID
ID
AM
ID
ID
ID
AM
AM
vv
AM
AM
AM
AM
AM
AM
AM
AM
AM
AM
AM
AM
AM
AM
AM
BL
ou
Hk
JS
JS
JS
JS
GK
"}
(18,1,1) = {"
BL
BL
Xm
JG
Nl
BL
FT
sK
Xw
Xw
fG
Cb
AM
AM
AM
AM
AM
AM
AM
QH
AM
AM
AM
AM
AM
ID
AM
ID
ID
ID
ID
ID
ID
ID
ID
ID
ID
ID
AM
AM
AM
vv
AM
AM
AM
AM
AM
AM
AM
AM
AM
AM
AM
AM
AM
AM
AM
JS
Bz
JS
JS
JS
fO
BL
LC
"}
(19,1,1) = {"
BL
sv
JS
sv
rv
ou
JS
JS
Ho
AM
AM
AM
AM
AM
AM
AM
AM
AM
AM
QH
AM
AM
AM
AM
ID
ID
ID
ID
ID
ID
ID
ID
ID
ID
ID
ID
AM
AM
AM
AM
AM
vv
AM
AM
AM
AM
AM
AM
AM
AM
AM
AM
AM
AM
AM
AM
Xw
BL
JS
JS
JS
Hk
JS
BL
BL
"}
(20,1,1) = {"
Jl
BL
BL
BL
JS
BL
ou
ou
Xw
AM
AM
AM
AM
AM
AM
AM
AM
AM
AM
QH
AM
AM
AM
AM
AM
ID
ID
ID
ID
ID
ID
ID
hq
ID
ID
ID
AM
AM
AM
AM
AM
vv
AM
AM
AM
AM
AM
AM
AM
AM
AM
AM
AM
AM
AM
fG
BL
BL
BL
mF
JS
JS
JS
BL
fO
"}
(21,1,1) = {"
BL
BL
ou
IZ
BL
BL
BL
JS
JS
Xw
AM
AM
AM
AM
AM
AM
AM
AM
AM
QH
AM
AM
AM
ID
ID
ID
ID
ID
ID
SH
ID
ID
ID
ID
ID
ID
AM
AM
AM
AM
AM
vv
AM
AM
AM
AM
AM
AM
AM
AM
AM
AM
AM
Cb
Xw
Xw
Xw
So
JS
JS
JS
JS
JS
fO
JS
"}
(22,1,1) = {"
BL
BL
ou
BL
BL
BL
BL
sv
Vs
BL
Xw
AM
AM
AM
AM
AM
AM
AM
AM
QH
AM
AM
AM
AM
ID
ID
ID
ID
hY
hq
hq
eR
ID
ID
ID
AM
AM
AM
AM
AM
AM
vv
AM
AM
AM
AM
AM
AM
AM
AM
AM
AM
AM
AM
AM
AM
fG
BL
FA
vH
dS
JS
JS
Hk
JS
"}
(23,1,1) = {"
BL
BL
Jl
JS
ou
JS
BL
BL
JS
JS
fG
fG
AM
AM
AM
AM
AM
AM
AM
QH
AM
AM
AM
AM
AM
ID
hq
ID
hq
NZ
hq
hq
ID
hq
ID
AM
AM
AM
AM
AM
AM
vv
AM
AM
AM
AM
AM
AM
AM
AM
AM
AM
AM
AM
AM
AM
Xw
BL
BL
JS
JS
JS
LC
JS
fO
"}
(24,1,1) = {"
Jl
BL
BL
BL
sF
vm
HP
JS
JS
cp
AM
AM
AM
AM
AM
AM
AM
AM
AM
QH
AM
AM
AM
ID
ID
ID
ID
ID
hY
la
hq
eR
ID
ID
ID
AM
AM
AM
AM
AM
AM
vv
AM
AM
AM
AM
AM
AM
AM
AM
AM
AM
AM
AM
AM
AM
AM
BL
OI
Hk
JS
JS
BL
BL
JS
"}
(25,1,1) = {"
BL
BL
Jl
BL
BL
BL
JS
Xw
fG
Xw
AM
AM
AM
AM
AM
AM
AM
AM
AM
QH
AM
AM
ID
ID
ID
ID
ID
ID
ID
Ty
ID
ID
hq
ID
ID
AM
AM
AM
AM
AM
AM
vv
AM
AM
AM
AM
AM
AM
AM
AM
AM
AM
AM
AM
AM
AM
AM
JS
Ty
Ty
Nl
JS
BL
ou
JS
"}
(26,1,1) = {"
BL
BL
sv
BL
JS
JS
dZ
Xw
Xw
Xw
AM
AM
AM
AM
AM
AM
AM
AM
AM
QH
AM
ID
ID
ID
ID
ID
ID
ID
ID
ID
ID
hq
ID
ID
ID
ID
AM
AM
AM
AM
AM
vv
AM
AM
AM
AM
AM
AM
AM
AM
AM
AM
AM
AM
AM
AM
AM
sK
Ty
Ty
cX
Hk
LC
ou
fO
"}
(27,1,1) = {"
BL
BL
BL
BL
dZ
ou
ou
Xw
ou
AM
AM
AM
AM
AM
AM
AM
AM
AM
AM
QH
AM
AM
AM
ID
ID
ID
hq
ID
ID
ID
ID
ID
ID
ID
AM
ID
ID
AM
AM
AM
AM
vv
AM
AM
AM
AM
AM
AM
AM
AM
AM
AM
AM
AM
AM
AM
AM
JS
JS
JS
JS
JS
BL
ou
ou
"}
(28,1,1) = {"
BL
Jl
BL
JS
JS
Hs
JS
Xw
Bz
AM
AM
AM
AM
AM
AM
AM
AM
AM
AM
QH
AM
AM
AM
AM
ID
ID
ID
ID
ID
ID
ID
ID
ID
ID
AM
AM
ID
AM
AM
AM
AM
vv
AM
AM
AM
AM
AM
AM
AM
AM
AM
AM
AM
AM
AM
AM
AM
Bz
BL
BL
Hl
JS
fO
BL
ou
"}
(29,1,1) = {"
BL
BL
BL
BL
aG
Ty
Ty
Ke
JS
AM
AM
AM
AM
AM
AM
AM
AM
AM
AM
QH
AM
AM
AM
AM
AM
AM
AM
AM
AM
ID
ID
ID
ID
ID
ID
AM
ID
AM
AM
AM
AM
vv
AM
AM
AM
AM
AM
AM
AM
AM
AM
AM
AM
AM
AM
AM
AM
BL
BL
Zi
BL
JS
JS
BL
BL
"}
(30,1,1) = {"
Jl
BL
sv
BL
Bz
Ty
Ty
JS
Xw
AM
AM
AM
AM
AM
AM
AM
AM
AM
AM
QH
AM
AM
AM
AM
AM
AM
AM
AM
AM
AM
AM
ID
AM
ID
ID
AM
ID
ID
AM
AM
AM
vv
AM
AM
AM
AM
AM
AM
AM
AM
AM
AM
AM
AM
AM
AM
AM
BL
Zi
Zi
JS
JS
JS
BL
LC
"}
(31,1,1) = {"
BL
BL
BL
BL
BL
Zi
JS
JS
JS
AM
AM
AM
AM
AM
AM
AM
AM
AM
AM
QH
AM
AM
AM
AM
AM
AM
AM
AM
AM
AM
AM
AM
AM
ID
ID
AM
AM
ID
AM
AM
AM
vv
AM
AM
AM
AM
AM
AM
AM
AM
AM
AM
AM
AM
AM
AM
AM
sv
BL
BL
dS
JS
fO
BL
BL
"}
(32,1,1) = {"
BL
ou
rv
Nl
BL
Zi
Zi
JS
ou
AM
AM
AM
AM
AM
AM
AM
AM
AM
AM
QH
AM
AM
AM
AM
AM
AM
AM
AM
AM
AM
AM
AM
AM
AM
ID
AM
AM
ID
AM
AM
AM
vv
AM
AM
AM
AM
AM
AM
AM
AM
AM
AM
AM
AM
AM
AM
AM
BL
ou
BL
fO
JS
JS
BL
BL
"}
(33,1,1) = {"
sK
JS
JS
JS
JS
BL
ou
ou
JS
AM
AM
AM
AM
AM
AM
AM
AM
AM
AM
QH
AM
AM
AM
AM
AM
AM
AM
AM
AM
AM
AM
AM
AM
AM
AM
AM
AM
AM
ID
AM
AM
vv
AM
AM
AM
AM
AM
AM
AM
AM
AM
AM
AM
AM
AM
Xw
Xw
BL
BL
BL
JS
JS
sv
LC
ou
"}
(34,1,1) = {"
cp
Hk
JS
Xw
Xw
Xw
sv
ou
fG
AM
AM
AM
AM
AM
AM
AM
AM
AM
AM
QH
AM
AM
AM
AM
AM
AM
AM
AM
AM
AM
AM
AM
AM
AM
AM
AM
AM
AM
AM
AM
AM
vv
AM
AM
AM
AM
AM
AM
AM
AM
AM
AM
AM
AM
AM
AM
Xw
BL
BL
BL
BL
BL
BL
BL
Hl
"}
(35,1,1) = {"
AM
Xw
Xw
AM
Xw
Xw
AM
AM
Xw
AM
AM
AM
AM
AM
AM
AM
AM
AM
AM
QH
AM
AM
AM
AM
AM
AM
AM
AM
AM
AM
AM
AM
AM
AM
AM
AM
AM
AM
AM
AM
AM
vv
AM
AM
AM
AM
AM
AM
AM
AM
AM
AM
AM
AM
AM
AM
Xw
Xw
AM
AM
Xw
Xw
Xw
AM
AM
"}
(36,1,1) = {"
AM
AM
Xw
AM
AM
cp
AM
AM
AM
AM
AM
AM
AM
AM
AM
AM
AM
AM
AM
QH
AM
AM
AM
AM
AM
AM
AM
AM
AM
AM
AM
AM
AM
AM
AM
AM
AM
AM
AM
AM
AM
vv
AM
AM
AM
AM
AM
AM
AM
AM
AM
AM
AM
AM
AM
AM
Xw
Xw
Xw
AM
Xw
Xw
Xw
Xw
Xw
"}
(37,1,1) = {"
AM
AM
AM
AM
AM
AM
AM
AM
AM
AM
AM
AM
AM
AM
AM
AM
AM
AM
AM
QH
AM
AM
AM
AM
AM
AM
AM
AM
AM
AM
AM
AM
AM
AM
AM
AM
AM
AM
AM
AM
AM
vv
AM
AM
AM
AM
AM
AM
AM
AM
AM
AM
AM
AM
AM
AM
AM
Xw
AM
AM
AM
Xw
Xw
Xw
AM
"}
(38,1,1) = {"
AM
AM
AM
AM
AM
AM
AM
AM
AM
AM
AM
AM
AM
AM
AM
AM
AM
AM
AM
QH
AM
AM
AM
AM
AM
AM
AM
AM
AM
AM
AM
AM
AM
AM
AM
AM
AM
AM
AM
AM
AM
vv
AM
AM
AM
AM
AM
AM
AM
AM
AM
AM
AM
AM
AM
AM
AM
AM
AM
AM
AM
AM
AM
AM
AM
"}
(39,1,1) = {"
AM
AM
AM
AM
AM
AM
AM
AM
AM
AM
AM
AM
AM
AM
AM
AM
AM
AM
AM
QH
AM
AM
AM
AM
AM
AM
AM
AM
AM
AM
AM
AM
AM
AM
AM
AM
AM
AM
AM
AM
AM
vv
AM
AM
AM
AM
AM
AM
AM
AM
AM
AM
AM
AM
AM
AM
AM
AM
AM
AM
AM
AM
AM
AM
AM
"}
(40,1,1) = {"
AM
AM
AM
AM
AM
AM
AM
AM
AM
AM
AM
AM
AM
AM
AM
AM
AM
AM
AM
QH
AM
AM
AM
AM
AM
AM
AM
AM
AM
AM
AM
AM
AM
AM
AM
AM
AM
AM
AM
AM
AM
vv
AM
AM
AM
AM
AM
AM
AM
AM
AM
AM
AM
AM
AM
AM
AM
AM
AM
AM
AM
AM
AM
AM
AM
"}
(41,1,1) = {"
AM
AM
AM
AM
AM
AM
AM
AM
AM
AM
AM
AM
AM
AM
AM
AM
AM
AM
AM
QH
AM
AM
AM
AM
AM
AM
AM
AM
AM
AM
AM
AM
AM
AM
AM
AM
AM
AM
AM
AM
AM
vv
AM
AM
AM
AM
AM
AM
AM
AM
AM
AM
AM
AM
AM
AM
AM
AM
AM
AM
AM
AM
AM
AM
AM
"}
(42,1,1) = {"
AM
AM
AM
AM
AM
AM
AM
AM
AM
AM
AM
AM
AM
AM
AM
AM
AM
AM
AM
QH
AM
AM
AM
AM
AM
AM
AM
AM
AM
AM
AM
AM
AM
AM
AM
AM
AM
AM
AM
AM
AM
vv
AM
AM
AM
AM
AM
AM
AM
AM
AM
AM
AM
AM
AM
AM
AM
AM
AM
AM
AM
AM
AM
AM
AM
"}
(43,1,1) = {"
AM
AM
AM
AM
AM
AM
AM
AM
AM
AM
AM
AM
AM
AM
AM
AM
AM
AM
AM
QH
AM
AM
AM
AM
AM
AM
AM
AM
AM
AM
AM
AM
AM
AM
AM
AM
AM
AM
AM
AM
AM
vv
AM
AM
AM
AM
AM
AM
AM
AM
AM
AM
AM
AM
AM
AM
AM
AM
AM
AM
AM
AM
AM
AM
AM
"}
(44,1,1) = {"
AM
AM
AM
AM
AM
AM
AM
AM
AM
AM
AM
AM
AM
AM
AM
AM
AM
AM
AM
QH
AM
AM
AM
AM
AM
AM
AM
AM
AM
AM
AM
AM
AM
AM
AM
AM
AM
AM
AM
AM
AM
vv
AM
AM
AM
AM
AM
AM
AM
AM
AM
AM
AM
AM
AM
AM
AM
AM
AM
AM
AM
AM
AM
AM
AM
"}
(45,1,1) = {"
AM
AM
AM
AM
AM
AM
AM
AM
AM
AM
AM
AM
AM
AM
AM
AM
AM
AM
AM
QH
AM
AM
AM
AM
AM
AM
AM
AM
AM
AM
AM
AM
AM
AM
AM
AM
AM
AM
AM
AM
AM
vv
AM
AM
AM
AM
AM
AM
AM
AM
AM
AM
AM
AM
AM
AM
AM
AM
AM
AM
AM
AM
AM
AM
AM
"}
