//MAP CONVERTED BY dmm2tgm.py THIS HEADER COMMENT PREVENTS RECONVERSION, DO NOT REMOVE
"a" = (
/turf/closed/mineral/random/rogue/high,
/area/rogue/outdoors)
"b" = (
/obj/machinery/light/rogue/torchholder/c,
/obj/structure/fermenting_barrel/beer,
/turf/open/floor/rogue/dirt/road,
/area/rogue/outdoors)
"c" = (
/turf/closed/wall/mineral/rogue/wooddark,
/area/rogue/outdoors)
"d" = (
/obj/machinery/light/rogue/firebowl/stump,
/obj/item/rogueweapon/pick,
/turf/open/floor/rogue/cobblerock,
/area/rogue/outdoors)
"e" = (
/obj/item/rogueweapon/pick,
/turf/open/floor/rogue/dirt/road,
/area/rogue/outdoors)
"f" = (
/obj/structure/roguemachine/musicbox,
/turf/open/floor/rogue/dirt/road,
/area/rogue/outdoors)
"g" = (
/turf/open/floor/rogue/dirt,
/area/rogue/outdoors)
"h" = (
/obj/effect/landmark/start/heartfeltinfantry,
/obj/structure/bed/rogue/sleepingbag,
/turf/open/floor/rogue/dirt/road,
/area/rogue/outdoors)
"i" = (
/obj/structure/table/wood/plain,
/obj/item/rogueweapon/pick,
/obj/item/rogueweapon/pick,
/obj/item/rogueweapon/pick,
/turf/open/floor/rogue/dirt,
/area/rogue/outdoors)
"j" = (
/obj/structure/fluff/ponr,
/turf/open/floor/rogue/dirt/road,
/area/rogue/outdoors)
"k" = (
/obj/machinery/light/rogue/hearth,
/obj/item/cooking/pan,
/turf/open/floor/rogue/grass,
/area/rogue/outdoors)
"l" = (
/obj/machinery/light/rogue/torchholder/r,
/turf/open/floor/rogue/cobble,
/area/rogue/outdoors)
"m" = (
/obj/structure/cannon,
/turf/open/floor/rogue/cobble,
/area/rogue/outdoors)
"n" = (
/obj/machinery/light/rogue/torchholder/r,
/turf/open/floor/rogue/dirt/road,
/area/rogue/outdoors)
"o" = (
/obj/structure/bed/rogue/sleepingbag,
/obj/effect/landmark/start/grenzelinfantry{
	dir = 1
	},
/turf/open/floor/rogue/dirt,
/area/rogue/outdoors)
"p" = (
/obj/structure/fermenting_barrel/beer,
/turf/open/floor/rogue/dirt,
/area/rogue/outdoors)
"q" = (
/obj/machinery/light/rogue/firebowl/stump,
/turf/open/floor/rogue/dirt,
/area/rogue/outdoors)
"r" = (
/turf/open/lava,
/area/rogue/outdoors)
"s" = (
/obj/structure/table/wood/plain,
/obj/item/reagent_containers/glass/bucket/wooden,
/turf/open/floor/rogue/dirt/road,
/area/rogue/outdoors)
"t" = (
/obj/machinery/light/rogue/hearth,
/obj/item/cooking/pan,
/turf/open/floor/rogue/dirt,
/area/rogue/outdoors)
"u" = (
/obj/machinery/light/rogue/torchholder/l,
/turf/open/floor/rogue/dirt/road,
/area/rogue/outdoors)
"v" = (
/obj/machinery/light/rogue/torchholder/r,
/turf/open/floor/rogue/grass,
/area/rogue/outdoors)
"w" = (
/obj/structure/table/wood/plain,
/obj/item/reagent_containers/glass/bucket/wooden,
/turf/open/floor/rogue/dirt,
/area/rogue/outdoors)
"x" = (
/turf/open/water/cleanshallow,
/area/rogue/outdoors)
"y" = (
/obj/machinery/light/rogue/firebowl/stump,
/turf/open/floor/rogue/dirt/road,
/area/rogue/outdoors)
"z" = (
/obj/machinery/light/rogue/firebowl/stump,
/turf/open/floor/rogue/cobblerock,
/area/rogue/outdoors)
"A" = (
/obj/item/rogueweapon/pick,
/turf/open/floor/rogue/cobblerock,
/area/rogue/outdoors)
"B" = (
/obj/structure/cannon{
	dir = 1
	},
/turf/open/floor/rogue/cobble,
/area/rogue/outdoors)
"C" = (
/obj/effect/landmark/start/heartfeltlord,
/turf/open/floor/rogue/dirt/road,
/area/rogue/outdoors)
"D" = (
/obj/structure/closet/crate/chest,
/obj/item/reagent_containers/food/snacks/rogue/meat/steak,
/obj/item/reagent_containers/food/snacks/rogue/meat/steak,
/obj/item/reagent_containers/food/snacks/rogue/meat/steak,
/obj/item/reagent_containers/food/snacks/rogue/meat/steak,
/obj/item/reagent_containers/food/snacks/rogue/meat/steak,
/obj/item/reagent_containers/food/snacks/rogue/meat/steak,
/obj/item/reagent_containers/food/snacks/rogue/meat/steak,
/obj/item/reagent_containers/food/snacks/rogue/meat/steak,
/obj/item/reagent_containers/food/snacks/rogue/meat/steak,
/obj/item/reagent_containers/food/snacks/rogue/meat/steak,
/turf/open/floor/rogue/grass,
/area/rogue/outdoors)
"E" = (
/turf/open/floor/rogue/cobblerock,
/area/rogue/outdoors)
"F" = (
/obj/item/grown/log/tree/small,
/obj/item/grown/log/tree/small,
/obj/item/grown/log/tree/small,
/obj/item/grown/log/tree/small,
/obj/item/grown/log/tree/small,
/obj/item/grown/log/tree/small,
/obj/item/grown/log/tree/small,
/obj/item/grown/log/tree/small,
/obj/item/grown/log/tree/small,
/obj/item/grown/log/tree/small,
/obj/item/grown/log/tree/small,
/obj/structure/closet/crate/chest,
/turf/open/floor/rogue/grass,
/area/rogue/outdoors)
"G" = (
/obj/structure/warfarebarrier/red,
/turf/closed/mineral/random/rogue/high,
/area/rogue/outdoors)
"H" = (
/turf/open/floor/rogue/dirt/road,
/area/rogue/outdoors)
"I" = (
/obj/machinery/light/rogue/torchholder/c,
/turf/open/floor/rogue/dirt/road,
/area/rogue/outdoors)
"J" = (
/obj/effect/decal/remains/human,
/turf/open/floor/rogue/cobble,
/area/rogue/outdoors)
"K" = (
/obj/item/rogueweapon/pick,
/turf/open/floor/rogue/grass,
/area/rogue/outdoors)
"L" = (
/obj/item/reagent_containers/glass/bucket/wooden,
/turf/open/floor/rogue/dirt/road,
/area/rogue/outdoors)
"M" = (
/obj/structure/fermenting_barrel/beer,
/turf/open/floor/rogue/dirt/road,
/area/rogue/outdoors)
"N" = (
/obj/structure/closet/crate/chest,
/obj/item/ammo_casing/caseless/rogue/cball,
/obj/item/ammo_casing/caseless/rogue/cball,
/obj/item/ammo_casing/caseless/rogue/cball,
/obj/item/ammo_casing/caseless/rogue/cball,
/obj/item/ammo_casing/caseless/rogue/cball,
/obj/item/ammo_casing/caseless/rogue/cball,
/obj/item/ammo_casing/caseless/rogue/cball,
/obj/item/ammo_casing/caseless/rogue/cball,
/obj/item/ammo_casing/caseless/rogue/cball,
/obj/item/ammo_casing/caseless/rogue/cball,
/obj/item/ammo_casing/caseless/rogue/cball,
/obj/item/ammo_casing/caseless/rogue/cball,
/obj/item/ammo_casing/caseless/rogue/cball,
/obj/item/ammo_casing/caseless/rogue/cball,
/turf/open/floor/rogue/cobble,
/area/rogue/outdoors)
"O" = (
/obj/effect/landmark/start/grenzellord{
	dir = 1
	},
/turf/open/floor/rogue/dirt/road,
/area/rogue/outdoors)
"P" = (
/obj/item/rogueweapon/pick,
/turf/open/floor/rogue/dirt,
/area/rogue/outdoors)
"Q" = (
/obj/effect/landmark/start/heartfeltinfantry,
/obj/structure/bed/rogue/sleepingbag,
/turf/open/floor/rogue/dirt,
/area/rogue/outdoors)
"R" = (
/obj/structure/warfarebarrier,
/turf/closed/mineral/random/rogue/high,
/area/rogue/outdoors)
"S" = (
/obj/structure/closet/crate/chest,
/obj/item/reagent_containers/food/snacks/rogue/crackerscooked,
/obj/item/reagent_containers/food/snacks/rogue/crackerscooked,
/obj/item/reagent_containers/food/snacks/rogue/crackerscooked,
/obj/item/reagent_containers/food/snacks/rogue/crackerscooked,
/obj/item/reagent_containers/food/snacks/rogue/crackerscooked,
/obj/item/reagent_containers/food/snacks/rogue/crackerscooked,
/obj/item/reagent_containers/food/snacks/rogue/crackerscooked,
/obj/item/reagent_containers/food/snacks/rogue/crackerscooked,
/turf/open/floor/rogue/dirt,
/area/rogue/outdoors)
"T" = (
/obj/structure/fluff/ponr/red,
/turf/open/floor/rogue/dirt,
/area/rogue/outdoors)
"U" = (
/turf/open/floor/rogue/grass,
/area/rogue/outdoors)
"V" = (
/obj/structure/table/wood/plain,
/turf/open/floor/rogue/dirt/road,
/area/rogue/outdoors)
"W" = (
/obj/structure/bed/rogue/sleepingbag,
/obj/effect/landmark/start/grenzelinfantry{
	dir = 1
	},
/turf/open/floor/rogue/dirt/road,
/area/rogue/outdoors)
"X" = (
/obj/structure/roguemachine/musicbox,
/turf/open/floor/rogue/dirt,
/area/rogue/outdoors)
"Y" = (
/turf/open/floor/rogue/cobble,
/area/rogue/outdoors)
"Z" = (
/obj/machinery/light/rogue/torchholder/l,
/turf/open/floor/rogue/grass,
/area/rogue/outdoors)

(1,1,1) = {"
a
a
a
a
a
a
a
a
a
a
a
a
a
a
a
a
a
a
a
G
a
a
a
a
a
a
a
a
a
a
a
a
a
a
a
a
a
a
a
a
a
R
a
a
a
a
a
a
a
a
a
a
a
a
a
a
a
a
a
a
a
a
a
a
a
"}
(2,1,1) = {"
a
a
a
a
a
a
a
a
a
a
a
a
a
a
a
a
a
a
a
G
a
a
a
a
a
a
a
a
a
a
a
a
a
a
a
a
a
a
a
a
a
R
a
a
a
a
a
a
a
a
a
a
a
a
a
a
a
a
a
a
a
a
a
a
a
"}
(3,1,1) = {"
a
a
a
a
a
a
a
a
a
a
a
a
a
a
a
a
a
a
a
G
a
a
a
a
a
a
a
a
a
a
a
a
a
a
a
a
a
a
a
a
a
R
a
a
a
a
a
a
a
a
a
a
a
a
a
a
a
a
a
a
a
a
a
a
a
"}
(4,1,1) = {"
a
a
a
a
a
a
a
a
a
a
a
a
a
a
a
a
a
a
a
G
a
a
a
a
a
a
a
a
a
a
a
a
a
a
a
a
a
a
a
a
a
R
a
a
a
a
a
a
a
a
a
a
a
a
a
a
a
a
a
a
a
a
a
a
a
"}
(5,1,1) = {"
a
a
a
a
a
a
a
a
a
a
a
a
a
a
a
a
a
a
a
G
a
a
a
a
a
a
a
a
a
a
a
a
a
a
a
a
a
a
a
a
a
R
a
a
a
a
a
a
a
a
a
a
a
a
a
a
a
a
a
a
E
E
a
a
a
"}
(6,1,1) = {"
a
a
a
a
a
a
a
a
a
a
a
a
a
a
a
a
a
a
a
G
a
a
a
a
a
a
a
a
a
a
a
a
a
a
a
a
a
a
a
a
a
R
a
a
a
a
a
a
a
a
a
a
a
a
a
a
a
a
a
a
E
E
a
E
a
"}
(7,1,1) = {"
a
a
a
a
a
a
a
a
a
a
a
a
a
a
a
a
a
a
a
G
a
a
a
a
a
a
a
a
a
a
a
a
a
a
a
a
a
a
a
a
a
R
a
a
a
a
a
a
a
a
a
a
a
a
a
a
a
a
a
E
E
E
a
E
a
"}
(8,1,1) = {"
a
a
a
a
a
a
a
a
a
a
a
a
a
a
a
a
a
a
a
G
a
a
a
a
a
a
a
a
a
a
a
a
a
a
a
a
a
a
a
a
a
R
a
a
a
a
a
a
a
a
a
a
a
a
a
E
E
a
E
g
g
E
E
E
a
"}
(9,1,1) = {"
a
a
a
a
a
a
a
a
a
a
a
a
a
a
a
a
a
a
a
G
a
a
a
a
a
a
a
a
a
a
a
a
a
a
a
a
a
a
a
a
a
R
a
a
a
a
a
a
a
a
a
a
a
a
E
E
E
E
g
U
g
g
E
E
a
"}
(10,1,1) = {"
a
a
a
a
a
a
a
a
a
a
a
a
a
a
a
a
a
a
a
G
a
a
a
a
a
a
a
a
a
a
a
a
a
a
a
a
a
a
a
a
a
R
a
a
a
a
a
a
a
a
a
a
a
a
E
E
E
E
g
U
U
x
g
g
g
"}
(11,1,1) = {"
a
E
a
a
a
a
a
a
a
a
a
a
a
a
a
a
a
a
a
G
a
a
a
a
a
a
a
a
a
a
a
a
a
a
a
a
a
a
a
a
a
R
a
a
a
a
a
a
a
a
a
a
a
a
E
E
E
g
g
g
U
x
x
g
g
"}
(12,1,1) = {"
z
E
E
a
E
E
a
a
a
a
a
a
a
a
a
a
a
a
a
G
a
a
a
a
a
a
a
a
a
a
a
a
a
a
a
a
a
a
a
a
a
R
a
a
a
a
a
a
a
a
a
a
a
a
E
E
g
g
U
U
g
g
q
p
g
"}
(13,1,1) = {"
E
P
E
E
H
y
E
a
a
a
a
a
a
a
a
a
a
a
a
G
a
a
a
a
a
a
a
a
a
a
a
a
a
a
a
a
a
a
a
a
a
R
a
a
a
a
a
a
a
a
a
a
a
a
a
E
g
S
g
g
g
t
H
H
p
"}
(14,1,1) = {"
H
U
U
U
H
H
H
H
E
a
a
a
a
a
a
a
a
a
a
G
a
a
a
a
a
a
a
a
a
a
a
a
a
a
a
a
a
a
a
a
a
R
a
a
a
a
a
a
a
a
a
a
a
a
a
E
F
c
c
g
D
g
M
e
w
"}
(15,1,1) = {"
H
g
H
x
x
H
U
M
e
E
a
a
a
a
a
a
a
a
a
G
a
a
a
a
a
a
a
a
a
a
a
a
a
a
a
a
a
a
a
a
a
R
a
a
a
a
a
a
a
a
a
a
a
a
a
a
U
c
c
I
t
U
H
H
g
"}
(16,1,1) = {"
g
q
c
c
M
x
H
H
H
E
a
a
a
a
a
a
a
a
a
G
a
a
a
a
a
a
a
r
r
a
a
r
r
r
a
a
a
a
r
r
a
R
a
a
a
a
a
a
a
a
a
a
a
a
a
a
a
Z
U
H
H
D
H
M
i
"}
(17,1,1) = {"
Q
D
c
c
b
g
w
H
E
E
a
a
a
a
a
a
a
a
a
G
a
a
a
a
a
a
a
a
r
r
r
r
Y
r
r
a
r
r
r
a
a
R
a
a
a
a
a
a
a
a
a
a
a
a
a
a
a
g
U
e
H
H
H
H
p
"}
(18,1,1) = {"
g
g
u
s
F
g
M
S
E
E
A
E
a
a
a
a
a
a
a
G
a
a
a
a
a
r
a
r
r
r
r
r
r
r
r
r
r
r
a
a
a
R
a
a
a
a
a
a
a
a
a
a
a
a
a
a
a
H
y
H
H
H
W
g
o
"}
(19,1,1) = {"
g
P
H
P
h
U
H
H
d
a
a
a
a
a
a
a
a
a
a
G
a
a
a
a
r
r
r
r
r
r
r
r
r
r
r
r
a
a
a
a
a
R
a
a
a
a
a
a
a
a
a
a
a
a
a
a
E
g
H
H
H
e
H
g
g
"}
(20,1,1) = {"
Q
g
g
g
H
g
U
U
E
a
a
a
a
a
a
a
a
a
a
G
a
a
a
a
a
r
r
r
r
r
r
r
Y
r
r
r
a
a
a
a
a
R
a
a
a
a
a
a
a
a
a
a
a
a
a
A
g
g
g
f
H
H
H
g
W
"}
(21,1,1) = {"
g
g
U
X
g
g
g
H
H
E
a
a
a
a
a
a
a
a
a
G
a
a
a
r
r
r
r
r
r
N
r
r
r
r
r
r
a
a
a
a
a
R
a
a
a
a
a
a
a
a
a
a
a
E
E
E
E
j
H
H
H
H
H
W
H
"}
(22,1,1) = {"
g
g
U
g
g
g
g
P
T
g
E
a
a
a
a
a
a
a
a
G
a
a
a
a
r
r
r
r
B
Y
Y
m
r
r
r
a
a
a
a
a
a
R
a
a
a
a
a
a
a
a
a
a
a
a
a
a
A
g
H
O
L
H
H
e
H
"}
(23,1,1) = {"
g
g
Q
H
U
H
g
g
H
H
A
A
a
a
a
a
a
a
a
G
a
a
a
a
a
r
Y
r
Y
J
Y
Y
r
Y
r
a
a
a
a
a
a
R
a
a
a
a
a
a
a
a
a
a
a
a
a
a
E
g
g
H
H
H
o
H
W
"}
(24,1,1) = {"
Q
g
g
g
K
H
C
H
H
z
a
a
a
a
a
a
a
a
a
G
a
a
a
r
r
r
r
r
B
l
Y
m
r
r
r
a
a
a
a
a
a
R
a
a
a
a
a
a
a
a
a
a
a
a
a
a
a
g
v
e
H
H
g
g
H
"}
(25,1,1) = {"
g
g
Q
g
g
g
H
E
A
E
a
a
a
a
a
a
a
a
a
G
a
a
r
r
r
r
r
r
r
c
r
r
Y
r
r
a
a
a
a
a
a
R
a
a
a
a
a
a
a
a
a
a
a
a
a
a
a
H
c
c
F
H
g
U
H
"}
(26,1,1) = {"
g
g
P
g
H
H
k
E
E
E
a
a
a
a
a
a
a
a
a
G
a
r
r
r
r
r
r
r
r
r
r
Y
r
r
r
r
a
a
a
a
a
R
a
a
a
a
a
a
a
a
a
a
a
a
a
a
a
S
c
c
I
e
o
U
W
"}
(27,1,1) = {"
g
g
g
g
k
U
U
E
U
a
a
a
a
a
a
a
a
a
a
G
a
a
a
r
r
r
Y
r
r
r
r
r
r
r
a
r
r
a
a
a
a
R
a
a
a
a
a
a
a
a
a
a
a
a
a
a
a
H
H
H
H
H
g
U
U
"}
(28,1,1) = {"
g
Q
g
H
H
n
H
E
y
a
a
a
a
a
a
a
a
a
a
G
a
a
a
a
r
r
r
r
r
r
r
r
r
r
a
a
r
a
a
a
a
R
a
a
a
a
a
a
a
a
a
a
a
a
a
a
a
y
g
g
q
H
W
g
U
"}
(29,1,1) = {"
g
g
g
g
V
c
c
D
H
a
a
a
a
a
a
a
a
a
a
G
a
a
a
a
a
a
a
a
a
r
r
r
r
r
r
a
r
a
a
a
a
R
a
a
a
a
a
a
a
a
a
a
a
a
a
a
a
g
g
x
g
H
H
g
g
"}
(30,1,1) = {"
Q
g
P
g
y
c
c
H
E
a
a
a
a
a
a
a
a
a
a
G
a
a
a
a
a
a
a
a
a
a
a
r
a
r
r
a
r
r
a
a
a
R
a
a
a
a
a
a
a
a
a
a
a
a
a
a
a
g
x
x
H
H
H
g
o
"}
(31,1,1) = {"
g
g
g
g
g
x
H
H
H
a
a
a
a
a
a
a
a
a
a
G
a
a
a
a
a
a
a
a
a
a
a
a
a
r
r
a
a
r
a
a
a
R
a
a
a
a
a
a
a
a
a
a
a
a
a
a
a
P
g
g
L
H
W
g
g
"}
(32,1,1) = {"
g
U
h
F
g
x
x
H
U
a
a
a
a
a
a
a
a
a
a
G
a
a
a
a
a
a
a
a
a
a
a
a
a
a
r
a
a
r
a
a
a
R
a
a
a
a
a
a
a
a
a
a
a
a
a
a
a
g
U
g
W
H
H
g
g
"}
(33,1,1) = {"
S
H
H
H
H
g
U
U
H
a
a
a
a
a
a
a
a
a
a
G
a
a
a
a
a
a
a
a
a
a
a
a
a
a
a
a
a
a
r
a
a
R
a
a
a
a
a
a
a
a
a
a
a
a
a
E
E
g
g
g
H
H
P
o
U
"}
(34,1,1) = {"
z
e
H
E
E
E
P
U
A
a
a
a
a
a
a
a
a
a
a
G
a
a
a
a
a
a
a
a
a
a
a
a
a
a
a
a
a
a
a
a
a
R
a
a
a
a
a
a
a
a
a
a
a
a
a
a
E
g
g
g
g
g
g
g
q
"}
(35,1,1) = {"
a
E
E
a
E
E
a
a
E
a
a
a
a
a
a
a
a
a
a
G
a
a
a
a
a
a
a
a
a
a
a
a
a
a
a
a
a
a
a
a
a
R
a
a
a
a
a
a
a
a
a
a
a
a
a
a
E
E
a
a
E
E
E
a
a
"}
(36,1,1) = {"
a
a
E
a
a
z
a
a
a
a
a
a
a
a
a
a
a
a
a
G
a
a
a
a
a
a
a
a
a
a
a
a
a
a
a
a
a
a
a
a
a
R
a
a
a
a
a
a
a
a
a
a
a
a
a
a
E
E
E
a
E
E
E
E
E
"}
(37,1,1) = {"
a
a
a
a
a
a
a
a
a
a
a
a
a
a
a
a
a
a
a
G
a
a
a
a
a
a
a
a
a
a
a
a
a
a
a
a
a
a
a
a
a
R
a
a
a
a
a
a
a
a
a
a
a
a
a
a
a
E
a
a
a
E
E
E
a
"}
(38,1,1) = {"
a
a
a
a
a
a
a
a
a
a
a
a
a
a
a
a
a
a
a
G
a
a
a
a
a
a
a
a
a
a
a
a
a
a
a
a
a
a
a
a
a
R
a
a
a
a
a
a
a
a
a
a
a
a
a
a
a
a
a
a
a
a
a
a
a
"}
(39,1,1) = {"
a
a
a
a
a
a
a
a
a
a
a
a
a
a
a
a
a
a
a
G
a
a
a
a
a
a
a
a
a
a
a
a
a
a
a
a
a
a
a
a
a
R
a
a
a
a
a
a
a
a
a
a
a
a
a
a
a
a
a
a
a
a
a
a
a
"}
(40,1,1) = {"
a
a
a
a
a
a
a
a
a
a
a
a
a
a
a
a
a
a
a
G
a
a
a
a
a
a
a
a
a
a
a
a
a
a
a
a
a
a
a
a
a
R
a
a
a
a
a
a
a
a
a
a
a
a
a
a
a
a
a
a
a
a
a
a
a
"}
(41,1,1) = {"
a
a
a
a
a
a
a
a
a
a
a
a
a
a
a
a
a
a
a
G
a
a
a
a
a
a
a
a
a
a
a
a
a
a
a
a
a
a
a
a
a
R
a
a
a
a
a
a
a
a
a
a
a
a
a
a
a
a
a
a
a
a
a
a
a
"}
(42,1,1) = {"
a
a
a
a
a
a
a
a
a
a
a
a
a
a
a
a
a
a
a
G
a
a
a
a
a
a
a
a
a
a
a
a
a
a
a
a
a
a
a
a
a
R
a
a
a
a
a
a
a
a
a
a
a
a
a
a
a
a
a
a
a
a
a
a
a
"}
(43,1,1) = {"
a
a
a
a
a
a
a
a
a
a
a
a
a
a
a
a
a
a
a
G
a
a
a
a
a
a
a
a
a
a
a
a
a
a
a
a
a
a
a
a
a
R
a
a
a
a
a
a
a
a
a
a
a
a
a
a
a
a
a
a
a
a
a
a
a
"}
(44,1,1) = {"
a
a
a
a
a
a
a
a
a
a
a
a
a
a
a
a
a
a
a
G
a
a
a
a
a
a
a
a
a
a
a
a
a
a
a
a
a
a
a
a
a
R
a
a
a
a
a
a
a
a
a
a
a
a
a
a
a
a
a
a
a
a
a
a
a
"}
(45,1,1) = {"
a
a
a
a
a
a
a
a
a
a
a
a
a
a
a
a
a
a
a
G
a
a
a
a
a
a
a
a
a
a
a
a
a
a
a
a
a
a
a
a
a
R
a
a
a
a
a
a
a
a
a
a
a
a
a
a
a
a
a
a
a
a
a
a
a
"}
